0000000000000000000
0000000000000000000
0000000000000000000
0000000000000000000
0000022222222200000
2000000000000000002
1200000000000000021
1122222222222222211
1111111111111111111
1111111111111111111
1111111111111111111
1111111111111111111
1111111111111111111